111111
100101
101001
1100N1
1xx11111