NO src/images/zlijfassi.xpm
SO src/images/zlijfassi.xpm
WE src/images/zlijfassi.xpm
EA src/images/zlijfassi.xpm

C      169,169,169
F      112,128,144

111111111111111111
100000000000000001
100000000000000001
100100000000010001
100100000000010001
100100000000010001
100000000000010001
100010000000010001
100010000000010001
100010000000010001
100010000000010001
100010000000010001
10001000N000010001
100010000000010001
101111111000010001
100000011111000011
100000011111000011
111111111111111111





