NO textures/texture0.xpm
SO textures/texture1.xpm
WE textures/texture2.xpm
EA textures/texture3.xpm

F 81,41,28
C 53,168,230

        1111111111111111111111111
        100000000011000000000001
        1011000001110000000000001
        1001000000000000000000001
111111111011000001110000000000001
100000000011000001110111111111111
1111011111111101110000001001
11110111111111011101010010001
110000001101010111000000100011
10000000000000001100000010001
1000N00000000000110101001001
11000001110101011111011110011
11110111 1110101 1011110100011
11111111 1111111 11111111111111