NO textures/texture0.xpm
SO textures/texture1.xpm
WE textures/texture2.xpm
EA textures/texture3.xpm

F 81,41,28
C 53,168,230

        1111111111111111111111111
        1000000000110000000000001
        1011000001110000000000001
        1001000000000000000000001
1111111110110000011100000000000S1
100000000011000001110111111111111
11110111111111011100000010001
11110111111111011101010010001
11000000110101011100000010001
10000000000000001100000010001
10000000000000001101010010001
110000011101010111110111100111
111101111110101 101111010001
1111111111111111 111111111111
