NO src/images/zlijfassi.xpm
SO src/images/kozina_2_.xpm
WE src/images/zlijcasa.xpm
EA src/images/zlpop.xpm

C      169,169,169
F      112,128,144

111111111111111111
100000000000000001
100000000000000001
100000000000000001
10000000000N000001
100000000000000001
100000000000000001
111111111111111111