NO src/images/zlijfassi.xpm
SO src/images/kozina_2_.xpm
WE src/images/zlijcasa.xpm
EA src/images/zlpop.xpm

C      169,169,169
F      112,128,144

1111
1101
1111
1101
11N1
1111





