NO images/zlijcasa.xpm
SO images/zlijfassi.xpm
WE images/zlpop.xpm
EA images/kozina_1_.xpm

C      0,0,0
F      255,255,255

111111
100101
101001
1100N1
111111