NO images/wall.xpm
SO images/brick-wall-19.xpm
WE images/brick-wall-19.xpm
EA images/wall.xpm

C      0,0,0
F      255,255,255

111111
100101
101001
1100E1
111111