NO textures/texture0.xpm
SO textures/texture1.xpm
WE textures/texture2.xpm

C 225,30,0
F 220,100,0
EA textures/texture3.xpm


1111111111
    1100001
 1111000N11
 111111111