NO images/zlijcasa.xpm
SO images/zlijfassi.xpm
WE images/zlpop.xpm
EA images/kozina_1_.xpm

C 225,30,0
F 220,100,0


1111111111
    1100001
 1111000S11
 111111111